11111
1CP11
11001
1C0E1
11111
