11111111111
1C1000001C1
1000C001101
1C010001001
10010000001
110000C1001
11011111111
1P00000EC01
11111111111
